####################
#P.......#.........#
#........#.........#
#........#.........#
#...######......E..#
#...######.........#
#.........######...#
#.........######...#
######.........#...#
######.........#...#
#..E...........#...#
#.......E......#...#
#...############...#
#..................#
####################