####################
#P.......B.........#
#........B.........#
#........B.........#
#...######......E..#
#...######.........#
#....L....######...#
#.........######...#
######.........#...#
######.........#...#
#..E...........#...#
#.......E......#...#
#...############...#
#..................#
####################