####################
#P.......#.........#
#........#.........#
#........#.........#
#...######.........#
#...######.........#
#.........######...#
#.........######...#
######.........#...#
######.........#...#
#..............#...#
#.......E......#...#
#...############...#
#..................#
####################